00000000000000000000000000000000000000000000000000000000000000000000000000000000000000000000000000000000
00000000000000000000000000000000000000000000000000000000000000000000000000000000000000000000000000000000
00000000000000000000000000000000000000000000000000000000000000000000000000000000000000000000000000000000
00000000000000000000000000000000000000000000000000000000000000000000000000000000000000000000000000000000
00000000000000000000000000000000000000000000000000000000000000000000000000000000000000000000000000000000
00000000000000000000000000000000000000000000000000000000000000000000000000000000000000000000000000000000
00000000000000000000000000000000000000000000000000000000000000000000000000000000000000000000000000000000
00000000000000000000000000000000000000000000000000000000000000000000000000000000000000000000000000000000
00000000000000000000000000000000000000000000000000000000000000000000000000000000000000000000000000000000
00000000000000000000000000000000000000000000000000000000000000000000000000000000000000000000000000000000
00000000000000000000000000000000000000000000000000000000000000000000000000000000000000000000000000000000
00000000000000000000000000000000000000000000000000000000000000000000000000000000000000000000000000000000
00000000000000000000000000000000000000000000000000000000000000000000000000000000000000000000000000000000
00000000000000000000000000000000000000000000000000000000000000000000000000000000000000000000000000000000
00000000000000000000000000000000000000000000000000000000000000000000000000000000000000000000000000000000
00000000000000000000000000000000000000000000000000000000000000000000000000000000000000000000000000000000
00000000000000000000000000000000000000000000000000000000000000000000000000000000000000000000000000000000
00000000000000000000000000000000000000000000000000000000000000000000000000000000000000000000000000000000
00000000000000000000000000000000000000000002000000000000000000000000000000000000000000000000000000000000
00000000000000000000000000000000000000000020220000000000000000000000000000000000000000000000000000000000
00000000000000000000000000000000000000000200002200000000000000000000000000000000000000000000000000000000
00000000000000000000000000000000000000002000000022222221222222222200000000000000000000000000000000000000
00000000000000000000000000000000000000002000000000000000000000000010000000000000000000000000000000000000
00000000000000000000000000000000000000002000000000000000000000000022000000000000000000000000000000000000
00000000000000000000000000000000000000002000000000000000000000000002000000000000000000000000000000000000
00000000000000000000000000000000000000002000000000000000000000000002000000000000000000000000000000000000
00000000000000000000000000000000000000000200000000000000000000000002000000000000000000000000000000000000
00000000000000000000000000000000000000000200000000000000000000000002000000000000000000000000000000000000
00000000000000000000000000000000000000000200000000000000000000000002000000000000000000000000000000000000
00000000000000000000000000000000000000000200000000000000000000000002000000000000000000000000000000000000
00000000000000000000000000000000000000000200000000000000000000000002000000000000000000000000000000000000
00000000000000000000000000000000000000000200000000000000000000000002000000000000000000000000000000000000
00000000000000000000000000000000000000000200000000000000000100000002000000000000000000000000000000000000
00000000000000000000000000000000000000000200000000000022222222222222000222222222221000000000000000000000
00000000000000000000000000000000000000000222222222222200000000000002222000000000020000000000000000000000
00000000000000000000000000000000000000002000000000002000000000000002000000000000020000000000000000000000
00000000000000000000000000000000000000020000000000002000000000000002000000000000020000000000000000000000
00000000000000000000000000000000000000200000000000002000000000000002000000000000002000000000000000000000
00000000000000000000000000000012222222000000000000002000000000000002000000000000002000000000000000000000
00000000000000000000000000000002000000000000000000002000000000000002000000000000012000000000000000000000
00000000000000000000000000000002000000000000000000002000000000000002222000000000002000000000000000000000
00000000000000000000000000000002000000000000000000002022222222222220002000000000002000000000000000000000
00000000000000000000000000000002000000000000000000002200000000000000002000000000002000000000000000000000
00000000000000000000000000000012000000000000000000002000000000000000002000000000000210000000000000000000
00000000000000000000000000000002000000000010000000020000000000000000002000000000000020000000000000000000
00000000000000001222222222222222222222222222222222210000000000000000002000000000000020000000000000000000
00000000000000000000000000000000020000000020000000000000000000000000002000000000000002000000000000000000
00000000000000000000000000000000020000000200000000000000000000000000002000000000000002000000000000000000
00000000000000000000000000000000022222222000000000000000000000000000002100000000000002000000000000000000
00000000000000000000000000000000020000020000000000000000000000000000002000000000002222000000000000000000
00000000000000000000000000000000020000220000000000000000000000000000002000000002220000200000000000000000
00001222222222222210000000000000220000202000000000000000000000000000002000000020000000200000000000000000
00000000000000000200000000000000200000200200000000000000000000000000002000000200000000200000000000000000
00000000000000000200000000000000200000200020000000000000000000000000002000002000000000200000000000000000
00000000000000000200000000000000200000200002000000000000000000000000002000020000000000200000000000000000
00000000000000000222222222222222200000200002000000000000000000000000002000200000000000020000000000000000
00000000000000000000000000020000200000200000200000000000000000000000002222000000000000020000000000000000
00000000000000000022222222200000222100200000020000000000000000000000002020000000000000020000000000000000
00000000000000000020000000000001200220200000002220000000022222222222222020000000000000002000000000000000
00000000000000000020000000000000200022200000000002220022200000000000000002100000000000002000000000000000
00000000000000000020000000000000200020020000000000002200000000000000000000200000000000002000000000000000
00000000000000000020000000000000200020002000000000012000000000000000000000200000000000000200000000000000
00000000000000000020000000000000200020000200000000002000000000000000000000200000000000000020000000000000
00000000000000000020000000000000222220000020000000002000000000000000000000200000000000000020000000000000
00000000000000000020000000000002002000000002000000002000000000000022222222220000000000000020000000000000
00000000000000000020000000000020002222222222200000002000000222222200000000002000000000000020000000000000
00000000000000000020000000000020002000000002020000002222222000000000000000002000000000000020000000000000
00000000000000000002100000000020002000000002002222220000000000000000000000002000000000000002000000000000
00000000000000000000200000000020102000000002000000220000000000000000000000002000000000000002000000000000
00000000000000000000200000000022222000000002000000002222222222222222222222222000000010000002000000000000
00000000000000000000200000000200002000000002100000000002000000200000000000002222222222222222222222210000
00001222222000000000200000002000002000000002000000000002000000200000000000002000000000000000000000020000
00000000000200000000210000020000002000000002000000000002000000200000000000002000000000000000000000020000
00000000000020000000200000200000002000000002000000000002000000200000000000002000000000000000000000020000
00000000000002000000200002000010002000000002000000000002000010200000000000012000000000000000000000020000
00000000000000200000200022222222222222222222222222222222222222200000000000002000000000000000000000020000
00000000000000022222222200200000002000000020000020000000000000200000000000002000000000000000000000020000
00000000000000020000200000200000002000000020000020000000000000222222222222222000000000000000000000020000
00000000000000120000200000210000002000000021000020000000000000020020000000002000000000000000000000020000
00000000000000020000200000200000002000000020000020000000000000020020000010002000000000000010000000020000
00000000000000022222200000200000002000000020000020000000000000020022222222222222222222222222222222210000
00000000000000000000200000200000002000000020000020000000000000120000000000002000000000000000000020020000
00000000000000000000210000210000002000000021000020000000000000020000000000002000000000000000000020020000
00000000000000000000200000200000002000000020000020000000000000020000000010002000000000000000000020020000
00000000000000000000200000200000002100000020000020000000000000022222222222222000000000000000000020020000
00000000000000000000200000200000002000000020000020000000000000020000000000002000000000000000000020020000
00000000000000000000200000210000002000000021000022222222222222220000000000002000000000000000000020020000
00000000000000000000200000200000002222222222222220000000000000020000000000002000000000000000000020020000
00000000000000000001222222222222222000002000000020000000000000020000001000002000000000000000000020020000
00000000000000000000200000000000000000002000000020000000000000022222222222222100000000000000000020020000
00000000000000000002000000000000000000002000000020000000000000120000000000020000000000000000000020020000
00000000000000000002000000000000000000002000000020000000000000020000000000020000000000000000000020020000
00000000000000000002000000000000000000002000000022222222222222220000000000021000000000000000000020020000
00000000000000000012000000010000000000002000000020000000000000020000000000020000000000000000000020020000
00000000000000000002222222222222222222222000000020000000000000020000000000020000000000000000000020020000
00000000000000000002000000002000000000000000000020000000000000020000001000020000000000000000000020020000
00000000000000000002000000020000000000000000000020000000000000022222222222220000000000000000000020020000
00000000000000000002000000200000000000000000000020000000000000020000000000020000000000100000000020020000
00000000000000000002000000200000000000000000000020000000000000020000000000022222222222222222222222221000
00000000000000000002000000200000000000000000000020000000000000020000000000020000000000020000000000020000
00000000000000000002000000200000000000000000000020000000000000020000000000020000000000020000000000020000
00000000000000000002000000200000000000000000000022000000100000020000000000020000000000020000000000020000
00000000000000000002000000200000000000000000000200222222222222222222222222220000000000020000000000020000
00000000000000000002000000200000000000000000002000020000000000200000000000021000000000020000000000020000
00000000000000000222000000200000000000000000002000020000000000200000000000020000000000020000000000020000
00000000000000000200000000200000000000000000002000020000000000200000000000020000000000022222222222220000
00000000000000000200000000200000000010000000002000020000000000200000000000020000000000020000001000020000
00000000000000000200000000222222222222222222222222220000000000200000000000022222222222220000000000020000
00000000000000000200000122200000020002000000020000020000000000200000000000020000000000000000000000020000
00000000000000000200000020000000020002000000020000020000000000200000000000020000000000000000000000020000
00000000000000000200000020000000020002000000020000020000000000200000000000020000000000000000000000020000
00000000000000000200000020000000020002000000020000020000000000200000000000020000000000000000000000020000
00000000000000000200000020000000020002222222220000022222222222200000000000020000000000000000000000020000
00000000000000000200000020000000020002000000020000020000000000222222222222220000000000000000000000020000
00000000000000000200000020000000020002000000020000020000000000200000020000000000000000000000000000020000
00000000000000000200000020000000020002000000020000020000000000200000020000000000000000000000000000020000
00000000000000000200000020000000020002000000020000020000000000200000020000000000000000000000000000020000
00000000222222222222222222222222222222222222222222220000000000200000020000000000000000000000000000020000
00000000200000000000000020000000002000000020000000020000000000200000021000000000000000000000000000020000
00000000200000000000000020000000012000000020000000020000000000200000020000000000000000000000000000020000
00000000100000000000000020000000002000000020000000020000000000200000020000000000000000000000000000020000
00000000000000000000000022222222222222222222222222222222222222222222220000000000000000000000000000020000
00000000000000000000000000000000000000000000000000000000000000200000000000000000000000000000000000020000
00000000000000000000000000000000000000000000000000000000000000200000000000000000000000000000000000020000
00000000000000000000000000000000000000000000000000000000000000200000000000000000000000000000000000020000
00000000000000000000000000000000000000000000000000000000000000200000000000000000000000000000000000020000
00000000000000000000000000000000000000000000000000000000000000200000000000000000000000000000000000020000
00000000000000000000000000000000000000000000000000000000000000200000000000000000000000000000000000020000
00000000000000000000000000000000000000000000000000000000000000200000000000000000000000000000000000020000
00000000000000000000000000000000000000000000000000000000000000200000000000000000000000000000000000020000
00000000000000000000000000000000000000000000000000000000000000100000000000000000000000000000000000020000
00000000000000000000000000000000000000000000000000000000000000000000000000000000000000000000000000020000
00000000000000000000000000000000000000000000000000000000000000000000000000000000000000000000000000020000
00000000000000000000000000000000000000000000000000000000000000000000000000000000000000000000000000020000
00000000000000000000000000000000000000000000000000000000000000000000000000000000000000000000000000020000
00000000000000000000000000000000000000000000000000000000000000000000000000000000000000000000000000020000
00000000000000000000000000000000000000000000000000000000000000000000000000000000000000000000000000000000
00000000000000000000000000000000000000000000000000000000000000000000000000000000000000000000000000000000